####################
#S                 #
# ########## ##### #
#          # #   # #
# ######## # ### # #
# #        #   # #E#
# ##########   #   #
####################

